                                                                                                                                                                                                                                                                                                                                                                                                                       ____________|__________|__|__|__________|____________                                                                                                                                                                                                                                               ",
                                                                                                                                                                                                                                                               _                                                             _                                                                                         \                                                   /                                                                                                                                                                                                                                               ",
                                                                                                                                                                                                                                                              |_|___________________________________________________________|_|                                                                                         \                                                 /                                                                                                                                                                                                                                                ",
                                                                                                                                                                                                                                                             /                                                                 \                                                                                         \_______________________________________________/                                                                                                                                                                                                                                                 ",
                                                                                                                                            /\          /\                                                                                                  /                                                                   \                                                                                              |    ____                   ____    |                                                                                                                                                                                                                                                       ",
  ____________________________________                                                                                                     ( (__________) )                                                                                                /                                                                     \                                                                                             |   |____|      _____      |____|   |                                                                                                                                                                                                                                                       ",
                                      |                                                                                                    /              \                                                                                               /_______________________________________________________________________\                                                                                ____________|______________|__|__|______________|____________                                                                                                                                                                                                                                           ",
                                      |                                                                                            _______/                \________                                                                                        _  |    _____       _____       _____       _____       _____    |  _                                                                                  \                                                           /                                                                                                                                                                                                                                           ",
                                      |                                                                                            \                               /                                                                                       |_|_|___|__|__|_____|__|__|_____|__|__|_____|__|__|_____|__|__|___|_|_|                                                                                  \                                                         /                                                                                                                                                                                                                                            ",
                                      |                                                                              ____________   \_____________________________/   ____________                                                                        /                                                                       \                                                                                  \_______________________________________________________/                                                                                                                                                                                                                                             ",
                                      |                                                                             /            \        |       ___       |        /            \                                                                      /                                                                         \                                                                                       |     _____        _______        _____     |                                                                                                                                                                                                                                                   ",
  _______________________             |                                                                     _______/             _\_______|______|_|_|______|_______/_             \_______                                                             /                                                                           \                                                                                      |    |     |      |   |   |      |     |    |                                                                                                                                                                                                                                                   ",
       |               | |            |                                                                    \                     \                                   /                     /                                                           /                                                                             \                                                                           __________|____|_____|______|___|___|______|_____|____|__________                                                                                                                                                                                                                                         ",
  _    |               |||            |                                                                     \_____________________\_________________________________/_____________________/                                                           /_______________________________________________________________________________\                                                                          \                                                               /                                                                                                                               O                                                                      O                        O         ",
   |   |               |||            |                                                                           |               |   |        _________        |   |               |                                                                        |   _____      _____      _____      _____      _____     _____   |                                                                                  \                                                             /                                                                                                                               |-|____________________________________________________________________|-|                      |-|________",
   |   |               |||            |                                                                           |     _____     |   |       |    |    |       |   |     _____     |                                                                     ___|__|__|__|____|__|__|____|__|__|____|__|__|____|__|__|___|__|__|__|___                                                                                \___________________________________________________________/                                                                                                                                | |\__/\__/\__/\__/\__/\__/\__/\__/\__/\__/\__/\__/\__/\__/\__/\__/\__/| |                      | |\__/\__/",
   |   |               |||            |                                                                ___________|____|__|__|____|___|_______|____|____|_______|___|____|__|__|____|___________             __                                  __      |                                                                         |                                                                                    |  _____    _____    _________    _____    _____  |   __                                                                        __                                                      | |__|___|___|___|___|___|___|___|___|___|___|___|___|___|___|___|___|_| |                      | |__|___|_",
   | O |               | |            |                                __                       __     \                       /                                        \                      /            \ \ \                               \ \ \    |                               ___________                               |                              __            __                                      | |     |  |     |  |    |    |  |     |  |     | |  \ \ \                                                                     \ \ \                                                    | ||___|___|___|___|___|___|___|___|___|___|___|___|___|___|___|___|___| |                      | ||___|___",
  _|   |               |.|            |                              / / /                    / / /     \_____________________/                                          \____________________/             / / /                         __    / / /    |         _________            |     |     |            _________         |  __                        / / /   __    / / /                          __         | |_____|  |_____|  |    |    |  |_____|  |_____| |  / / /          __                                                   __    / / /                                                    | |__|___|___|___|___|___|___|___|___|___|___|___|___|___|___|___|___|_| |                      | |__|___|_",
       |               | |            |                         __   \ \ \                    \ \ \          |               /____________________________________________\\            _|                  \ \ \    __                  \ \ \  \ \ \    |        |    |    | __        |     |     |           |    |    |        | \ \ \                      \ \ \  \ \ \  \ \ \                         \ \ \       |                   |    |    |                   |  \ \ \         \ \ \                       __                       \ \ \  \ \ \                                                    | ||___|___|___|___|___|___|___|___|___|___|___|___|___|___|___|___|___| |                      | ||___|___",
       |               | |            |                       / / /  / / /   __               / / /   __     |       ___________   |          ___________          |   ___________   / / /                  / / /  / / /                 / / /  / / /   _|        |    |    / / /       |    .|.    |           |    |    |    __  | / / /                      / / /  / / /  / / /                         / / /  ||___|___________________|____|____|___________________|_ / / /   __    / / /              __     / / /                      / / /  / / /   __                                               | |__|___|___|___|___|___|___|___|___|___|___|___|___|___|___|___|___|_| |                      | |__|___|_",
       |               |||            |                       \ \ \  \ \ \  \ \ \             \ \ \  \ \ \   |      |     |     |  |         |     |     |         |  |     |     |  \ \ \                  \ \ \  \ \ \                 \ \ \  \ \ \  \ \ \      |   .|.   \ \ \    __ |     |     |           |   .|.   |   \ \ \| \ \ \                      \ \ \  \ \ \  \ \ \                         \ \ \ |       _/_____________/               \_____________\_    \ \ \  \ \ \  \ \ \             \ \ \   \ \ \                      \ \ \  \ \ \  \ \ \                                             | ||___|___|___|___|___|___|___|___|___|___|___|___|___|___|___|___|___| |                      | ||___|___",
  _    |               \||            |                       / / /  / / /  / / /             / / /  / / /   |      |    .|.    |  |         |    .|.    |         |  |    .|.    |  / / /                  / / /  / / /                 / / /  / / /  / / /      |    |    / / /  / / /|     |     |           |    |    |   / / /| / / /                      / / /  / / /  / / /                         / / / |     _/______________/                 \______________\_  / / /  / / /  / / /             / / /   / / /                      / / /  / / /  / / /                                             | |__|___|___|___|___|___|___|___|___|___|___|___|___|___|___|___|___|_| |                      | |__|___|_",
  _|___|________________\|            |                       \ \ \  \ \ \  \ \ \             \ \ \  \ \ \   |      |     |     |  |         |     |     |         |  |     |     |  \ \ \                  \ \ \  \ \ \                 \ \ \  \ \ \  \ \ \      |    |    \ \ \  \ \ \|     |     |           |    |    |   \ \ \| \ \ \                      \ \ \  \ \ \  \ \ \                         \ \ \ |    /_______________/                   \_______________\ \ \ \  \ \ \  \ \ \             \ \ \   \ \ \                      \ \ \  \ \ \  \ \ \                                             | ||___|___|___|___|___|___|___|___|___|___|___|___|___|___|___|___|___| |                      | ||___|___",
