                                                                                                                                                                                                                                                                                                                                                                                                                                                                  /                                                                                                                                                                                                                                                         
                                                                                                                                                                                                                                                                                                                                                                                                                                                                 /                                                                                                                                                                                                                                                          
~~~~~~~~~~~~~~~~~~~~~~~~~~~~~~~~~~~~~~~~~~~~~~~~~~~~~~~~~~~~~~~~~~~~~~~~~~~~~~~~~~~~~~~~~~~~~~~~~~~~~~~~~~~~~~~~~~~~~~~~~~~~~~~~~~~~~~~~~~~~~                                                                                                                                                                                                                                                                                                                   /                                                                                                                                            /  \ | /  \                                                                                                    
                                                                                                                                             `~~~~~~~~~~~~~~~~~~~~~~~~~~~~~~~~~~~~~~~~~~~~~~~~~~~~~~~~~~~~~~~~                                                                                                                                                                                                                                                 /                                                                                                                                                 \|/                                                                                                        
                                                                                                                                                                                                  O           `~~~~~~~~~~~~~~~~~~~~~~~~~~~~~~~~~~~~~~~~~~~~~~~~~~~~~~~~~~~~~                                                                                                                                                                                  /                                                                                                                                             _,.---v---._                                                                                                    
                                                                                                                                                                                                  . o                                              .  .  o .                `~~~~~~~~~~~~~~~~~~~~~~~~~~~~~~~~~~~~~~~~~~~~~~~~~~~~~~~~~~                                                                                                                      /                                                                                                                                     /\__/\  /            \                                                                                                   
                                                                             o .                                                                                                                 o  .  (' )<                                         o .    o                                                                          `~~~~~~~~~~~~~~~~~~~~~~~~~~~~~~~~~~~~~~~~~~~~~~~~~~~~~~~~~~~~~~                                                      /                                                                                                                                      \_  _/ /           .  \                                                                                                  
                                                                         _______  O                                                                                                       >( ')     (' )<                                          .  o  o  .      ,                                                                                                                                  `~~~~~~~~~~~~~~~~~~~~~~~~~~~~~~~~~~~~~~~~~~~~~~~~~~~~/~~~~~~~~~~~~~                                                                                                                            \ \_|           @ __|                                                                                                  
                                                                      |\/   )) .\                                                                                                             >( ')                                              o   .   o       .';                                                                                                                                 o                                        o  .   O    /              `~~~~~~~~~~~~~~~~~~~~~~~~~~~~~~~~~~~~~~~~~~~~~~~~~~~~~~~~                                                                    \                \_                                                                                                   
                                                         _______      |/\_______/                                     . o                o    .                                                                                                    .  o  .   .-'` .'                                                                                                        ______               O  .                                          .   o     /                                                        o .             `~~~~~~~~~~~~~~~~~~~~~~~~~~~~~~~~~~~~~~~~~~~~~~~~~~~~~~~~            \     ,__/       /                                                                                                   
                                                      |\/   )) .\                                                    .     >( ')             .  o                                                                                                  O  .    ,`.-'-.`\                                                                                                     .'        '.             . o                                          O  .     /                                                       .    o                                                                    `~~~~~~~~~~~~`~~~~~~~~~~~~~~~~~~~~~~~~~~~~~~~~~~~~~~~~~~~~~~~~                                                                   
                                                      |/\_______/                                     .     >( ')               o   >( ')                                   ___                                                                           ; /     '-'                       o  .                                                                        /            \                                                          . o    |              (' )<                                                                                                                                                                              `~~~~~~~~~~~~~~~~~~~~~~~~~~~~~~~~~~~~~~~~~~~~~~~~~~~~~~~~~~~~~~~~~~
                                                                                                       o              >( ')    .       .                                   \ \  \                                                                         | \       ,-,                     . O                                                                        (-._.-.__.-._.-)      .---.                                                     |                                                                                                                                                                                                                                                                    
                                                                                                                                              >( ')                        / /  /                                                                         \  '-.__   )_`'._                   o  .                                                                      '-//--//--//-'      (.-.-.)                                    _____           |     ________  __                                                                                                                                                                                                                                                   
                                                                                                                           >( ')          o                                \ \  \                                                                          '.     ```      ``'--._            . o   _______                                                              ((  ((  ((          )) ))                                  |\| (( .\          |    /_ ^     |/  |                                                                                                                                                                                                                                                  
                                              ___                                                               >( ')             >( ')                                    / /  /                                                                         .-' ,                   `'-.      o  . |\/   (( 8\                                                              ))  ))  ))        (( ( (                                  |/|_____/          |+   |_|      |   |                                                                                                                                                                                                                                                  
          ___                                \ \  \                                 ___                                                                                    \ \  \                                                                          '-'`-._           ((   o   )      o   |/\_______/                                         __                  //  ((  //           )   )                                                    U    \________|\__|                                                                                                                                                                                                                                                  
        / /  /                               / /  /                               /  / /                                                                          ___      / /  /                                                     ___                         `'--....(`- ,__..--'                .   o  .                                     / / /                ((    U ((                                                            >( ')                                                                                                                                                                                                                                                                         
   __   \ \  \                       ___     \ \  \                               \  \ \                                                                ___      \ \  \    \ \  \                                                    \ \  \                                '-'`                        o  . o  _______                             \ \ \                 U       U                                                                                                                                                                                                                                                                                                                                          
  /  |  / /  /                      \ \  \   / /__/____                           /  / /    ___                                                        /   |     / /  /    / /  /                                                    / /  /    ___                                                     . O  |\/   (( 8\                            / / /    ___                                                                                                                                                                                                                                                                                                                                                             
 |    \ \ \  \                      / /  /   \_/       \__                        \  \ \   \ \  \                                                     |    |    _\_\  \    \ \  \                                                    \ \  \   \ \  \                                                      o |/\_______/                      __    \ \ \   \ \ \                                                                                                                                        ____                                                                                                                                                                                              __..--````````````
/  |   |/ /  /                      \ \  \   /      \__   \                       /  / /   / /  /                                                    /      \  |   \  /    / /  /                                                    / /  /   / /  /                                                                                       / / /   / / /   / / /                                                                                                                                    ___/    \_                                                                                                                                                                                    __..--``           ('o')  
    \   \ \  \                      / /  /  |          \_  \                      \  \ \   \ \  \                                                   |   _/   \_/ _/ | \    \ \  \                                                    \ \  \   \ \  \                                                                                       \ \ \   \ \ \   \ \ \                                                                                                                                   /    _/    \                                                                                                                                                                           __..--``                  ((( ))) 
\        |/  /                      \ \  \  |              /                      /  / /   / /  /                                                   |         /      \/    / /  /                                                    / /  /   / /  /                                                                                       / / /   / / /   / / /                                                                                                                                  |            |                                                                                                                                                                     .--``                                  