                                                                                                                                                                                                                                                                                                                                                                                                                                                                                                                                                                                                                                                                                                                           
                                                                                                                                                                                                                                                                                                                                                                                                                                                                                                                                                                                                                                                                                                                           
  _____________________________________________________________                                                                                                                                                                                                                                                                                                                  ___________________________________________________________________________________________________________________________________________________________________________________________________                                                                                                                                       
  _   __   __   __   __   __   __   __   __   __   __   __   __|                                  _______________________________________________________________________________________________________________________________                                                      ______________________________________________________________                           |  ___   ___   ___   ___   ___   ___   ___   ___   ___   ___   ___   ___   ___   ___   ___   ___     ___   ___   ___   ___   ___   ___   ___   ___   ___   ___   ___   ___   ___   ___   ___   ___  |                                                                                                                                      
   | |  | |  | |  | |  | |  | |  | |  | |  | |  | |  | |  | |                                    |__   __   __   __   __   __   __   __   __   __   __   __   __   __   __   __   __   __   __   __   __   __   __   __   __   __|                                                    |__   __   __   __   __   __   __   __   __   __   __   __   __|                          | |   | |   | |   | |   | |   | |   | |   | |   | |   | |   | |   | |   | |   | |   | |   | |   |   |   | |   | |   | |   | |   | |   | |   | |   | |   | |   | |   | |   | |   | |   | |   | |   | |                                                                                                                                      
   | |  | |  | |  | |  | |  | |  | |  | |  | |  | |  | |  | |                                       | |  | |  | |  | |  | |  | |  | |  | |  | |  | |  | |  | |  | |  | |  | |  | |  | |  | |  | |  | |  | |  | |  | |  | |  | |                                                          | |  | |  | |  | |  | |  | |  | |  | |  | |  | |  | |  | |                             | |   | |   | |   | |   | |   | |   | |   | |   | |   | |   | |   | |   | |   | |   | |   | |   |   |   | |   | |   | |   | |   | |   | |   | |   | |   | |   | |   | |   | |   | |   | |   | |   | |                                                                 _____________________________________________________________________
   | |  | |  | |  | |  | |  | |  | |  | |  | |  | |  | |  | |                                       | |  | |  | |  | |  | |  | |  | |  | |  | |  | |  | |  | |  | |  | |  | |  | |  | |  | |  | |  | |  | |  | |  | |  | |  | |                                                          | |  | |  | |  | |  | |  | |  | |  | |  | |  | |  | |  | |                             | |   | |   | |   | |   | |   | |   | |   | |   | |   | |   | |   | |   | |   | |   | |   | |   |   |   | |   | |   | |   | |   | |   | |   | |   | |   | |   | |   | |   | |   | |   | |   | |   | |                                                                |                                                                     
   | |  | |  | |  | |  | |  | |  | |  | |  | |  | |  | |  | |                                       | |  | |  | |  | |__| |__| |  | |  | |__| |__| |  | |  | |  | |  | |  | |  | |__| |__| |  | |  | |__| |__| |  | |  | |  | |                                                          | |  | |  | |  | |__| |__| |  | |  | |__| |__| |  | |  | |                             | |   | |   | |   | |   | |   | |   | |   | |   | |   | |   | |   | |   | |   | |   | |   | |   |   |   | |   | |   | |   | |   | |   | |   | |   | |   | |   | |   | |   | |   | |   | |   | |   | |                                                                |                                                                     
   | |  | |  | |  | |  | |  | |  | |  | |  | |  | |  | |  | |                                       | |  | |  | |  |  _______  |  | |  |  _______  |  | |  | |  | |  | |  | |  |  _______  |  | |  |  _______  |  | |  | |  | |                                                          | |  | |  | |  |  _______  |  | |  |  _______  |  | |  | |                             | |   | |   | |   | |   | |   | |   | |   | |   | |   | |   | |   | |   | |   | |   | |   | |   |   |   | |   | |   | |   | |   | |   | |   | |   | |   | |   | |   | |   | |   | |   | |   | |   | |                                                                |                                                                     
   | |  | |  | |  | |  | |  | |  | |  | |  | |  | |  | |  | |                                       | |__| |__| |__| | | | | | |__| |__| | | | | | |__| |__| |__| |__| |__| |__| | | | | | |__| |__| | | | | | |__| |__| |__| |                                                          | |__| |__| |__| | | | | | |__| |__| | | | | | |__| |__| |                             | |   | |   | |   | |   | |   | |   | |   | |   | |   | |   | |   | |   | |   | |   | |   | |   |   |   | |   | |   | |   | |   | |   | |   | |   | |   | |   | |   | |   | |   | |   | |   | |   | |                                                                |                                                                     
   | |__| |__| |__| |__| |__| |__| |__| |__| |__| |__| |__| |                                       |  __   __   __  | | | | |  __   __  | | | | |  __   __   __   __   __   __  | | | | |  __   __  | | | | |  __   __   __  |                                                          |  __   __   __  | | | | |  __   __  | | | | |  __   __  |                             | |___| |___| |___| |___| |___| |___| |___| |___| |___| |___| |___| |___| |___| |___| |___| |___|   |___| |___| |___| |___| |___| |___| |___| |___| |___| |___| |___| |___| |___| |___| |___| |___| |                                                                |                                                                     
   |  __   __   __   __   __   __   __   __   __   __   __  |                                       | |  | |  | |  | | | | |.| |  | |  | | | | |.| |  | |  | |  | |  | |  | |  | | | | |.| |  | |  | | | | |.| |  | |  | |  | |                                                          | |  | |  | |  | | | | |.| |  | |  | | | | |.| |  | |  | |                             |  ___   ___   ___   ___   _______________   ___   ___   ___   _______________   ___   ___   ___     ___   ___   ___   _______________   ___   ___   ___   _______________   ___   ___   ___   ___  |                                                                |                       _________________ ________________ ___________
   | |  | |  | |  | |  | |  | |  | |  | |  | |  | |  | |  | |                                       | |  | |  | |  | | | | | | |  | |  | | | | | | |  | |  | |  | |  | |  | |  | | | | | | |  | |  | | | | | | |  | |  | |  | |                                                          | |  | |  | |  | | | | | | |  | |  | | | | | | |  | |  | |                             | |   | |   | |   | |   | |   |   |   |   | |   | |   | |   | |   |   |   |   | |   | |   | |   |   |   | |   | |   | |   |   |   |   | |   | |   | |   | |   |   |   |   | |   | |   | |   | |   | |                                                                |                      |                 |                |           
   | |  | |  | |  | |  | |  | |  | |  | |  | |  | |  | |  | |                                       | |  | |  | |  | | | | | | |  | |  | | | | | | |  | |  | |  | |  | |  | |  | | | | | | |  | |  | | | | | | |  | |  | |  | |                                                          | |  | |  | |  | | | | | | |  | |  | | | | | | |  | |  | |                             | |   | |   | |   | |   | |   |   |   |   | |   | |   | |   | |   |   |   |   | |   | |   | |   |   |   | |   | |   | |   |   |   |   | |   | |   | |   | |   |   |   |   | |   | |   | |   | |   | |                                                                |                      |    _  _  _  _   |                |    _  _  _
   | |  | |  | |  | |  | |  | |  | |  | |  | |  | |  | |  | |                                      _|_|__|_|__|_|__|_|_|_|_|_|_|__|_|__|_|_|_|_|_|_|__|_|__|_|__|_|__|_|__|_|__|_|_|_|_|_|_|__|_|__|_|_|_|_|_|_|__|_|__|_|__|_|__                                                       _|_|__|_|__|_|__|_|_|_|_|_|_|__|_|__|_|_|_|_|_|_|__|_|__|_|__                           | |   | |   | |   | |   | |   |   |   |   | |   | |   | |   | |   |   |   |   | |   | |   | |   |   |   | |   | |   | |   |   |   |   | |   | |   | |   | |   |   |   |   | |   | |   | |   | |   | |                                                                |                      |   | || || || |  |                |   | || || 
   | |  | |  | |  | |  | |  | |  | |  | |  | |  | |  | |  | |                                     |                   _________          _________                                _________          _________                   |                                                     |                 _________          _________                |                          | |   | |   | |   | |   | |   |   |   |   | |   | |   | |   | |   |   |   |   | |   | |   | |   |   |   | |   | |   | |   |   |   |   | |   | |   | |   | |   |   |   |   | |   | |   | |   | |   | |                                                                |                      |   | || || || |  |                |   | || || 
   | |  | |  | |  | |  | |  | |  | |  | |  | |  | |  | |  | |                                     |          ____    |  _____  |        |  _____  |    ____              ____    |  _____  |        |  _____  |    ____          |                                                     |        ____    |  _____  |        |  _____  |    ____       |                          | |   | |   | |   | |   | |   |   |   |   | |   | |   | |   | |   |   |   |   | |   | |   | |   |   |   | |   | |   | |   |   |   |   | |   | |   | |   | |   |   |   |   | |   | |   | |   | |   | |                                                                |                      |   | || || || |  |                |   | || || 
   | |  | |  |  _______  |  | |  |  _______  |  | |  | |  | |                                     |         |____|   | | | | | |        | | | | | |   |____|            |____|   | | | | | |        | | | | | |   |____|         |                                                     |       |____|   | | | | | |        | | | | | |   |____|      |                          | |   | |   | |   | |   | |   |   |   |   | |   | |   | |   | |   |   |   |   | |   | |   | |   |   |   | |   | |   | |   |   |   |   | |   | |   | |   | |   |   |   |   | |   | |   | |   | |   | |                                                                |                      |   | || || || |  |                |   | || || 
   | |  | |  | |       | |  | |  | | | | | | |  | |  | |  | |                                     |                  | | | | | |        | | | | | |                              | | | | | |        | | | | | |                  |                                                     |                | | | | | |        | | | | | |               |                          | |   | |   | |   | |   | |   |   |   | . | |   | |   | |   | |   |   |   | . | |   | |   | |   |   |   | |   | |   | |   |   |   | . | |   | |   | |   | |   |   |   | . | |   | |   | |   | |   | |                                                                |                      |   |_||_||_||_|  |                |   |_||_||_
  _| |__| |__| |       | |__| |__| | | | | | |__| |__| |__| |                                     |                  | |_|_|_| |        | |_|_|_| |                              | |_|_|_| |        | |_|_|_| |                  |                                                     |                | |_|_|_| |        | |_|_|_| |               |                          | |___| |___| |___| |___| |   |   |   |   | |___| |___| |___| |   |   |   |   | |___| |___| |___|   |___| |___| |___| |   |   |   |   | |___| |___| |___| |   |   |   |   | |___| |___| |___| |___| |                                                                |                      |                 |                |  O        
  _   __   __  |       |  __   __  | | | | |  __   __   __  |                                     |                  |         |        |         |                              |         |        |         |                  |                                                     |                |         |        |         |               |                          |  ___   ___   ___   ___  |   |   |   |   |  ___   ___   ___  |   |   |   |   |  ___   ___   ___     ___   ___   ___  |   |   |   |   |  ___   ___   ___  |   |   |   |   |  ___   ___   ___   ___  |                                                                |                      |                 |                |           
   | |  | |  | |       | |  | |  | | | | |.| |  | |  | |  | |                                     |                  |       . |        | .       |                              |       . |        | .       |                  |                                                     |                |       . |        | .       |               |                          | |   | |   | |   | |   | |   |   |   |   | |   | |   | |   | |   |   |   |   | |   | |   | |   |   |   | |   | |   | |   |   |   |   | |   | |   | |   | |   |   |   |   | |   | |   | |   | |   | |                                                                |                      |                 |                |           
   | |  | |  | |       | |  | |  | | | | | | |  | |  | |  | |                                     |                  |  _____  |        |  _____  |                              |  _____  |        |  _____  |                  |                                                     |                |  _____  |        |  _____  |               |                          | |   | |   | |   | |   | |   |   |   |   | |   | |   | |   | |   |   |   |   | |   | |   | |   |   |   | |   | |   | |   |   |   |   | |   | |   | |   | |   |   |   |   | |   | |   | |   | |   | |                                                                |                      |    _  _  _  _   |                |    _  _  _
   | |  | |  | |       | |  | |  | | | | | | |  | |  | |  | |                                     |                  | | | | | |        | | | | | |                              | | | | | |        | | | | | |                  |                                                     |                | | | | | |        | | | | | |               |                          | |   | |   | |   | |   | |   |   |   |   | |   | |   | |   | |   |   |   |   | |   | |   | |   |   |   | |   | |   | |   |   |   |   | |   | |   | |   | |   |   |   |   | |   | |   | |   | |   | |                                                                |                      |___|_||_||_||_|__|________________|___|_||_||_
