                                                                                                                                                                                                                                                                                                                                                                                                                                                                                                                                                                                                                                                                                                                           ",
                                                                                                                                                                                                                                                                                                                                                                                                                                                                                                                                                                                                                                                                                                                           ",
                                                                                                                                                                                                                                         .  O          . o                                                   _____                                                                                                                                                                                                                                                                                                                                                                                                         ",
                                                                                                                                                  . o                                                                      O                .          o                                             ________\    |                                                                                                                                                                                                                                                                                                                                                                                                        ",
                                                                                                                                                  o .                                                                      . o            o      >( ')                                            _ /         \  /                                                                                                                                                                                                                                   ___                                                                                                                                                                   ",
                                                                                                                                          _______  O                                                                        .     >( ')                                                        __/ _\   .     /\/                                                                                                                                                                                                                                   ( _ \                                                                                                                                                                  ",
                                                                                                                                       |\/   )) .\                                                           .     >( ')                   >( ')                                              / __/ _\ < .   /                                                                                                                                                                                                                                      ( __ \                                                                                                                                                                 ",
                                                                                                                          _______      |/\_______/                                                            o              >( ')            .                                                / __/ _\_____/                                                                                                                                                                                                                                       ( ___ \                                                                                                                                                                ",
                                                                                                                       |\/   )) .\                                                                      >( ')                               o                                                   / __/                                                                          _______          o     .                                                                                                                                    _________(______\__________________                                                                                                                                             ",
                                                                                                                       |/\_______/                                                                                 >( ')             >( ')                                                       /                                                                          |\/   )) .\          . o                                                                                 . o                                                  (                                   \                                                                                                                                            ",
                                                                                                                                                                                                                                                                                                                                                                            |/\_______/          _______                                                      O                      o                                                    (                                    \                                                                                                                                           ",
                                                                                                                                                                                                                            >( ')                                                                                                                                                             |\/   )) .\                                                     . o                      >( ')                                              (                                 ^   |                                                                                                                                          ",
                                                                                                                                                                                                                                                                                                                                                                                .             |/\_______/                                                      .   >( ')                                                                  (                   __ /  /       O   |                                                                                                                                          ",
                                                                                                                                                                                                                                                                                                                                                                                  o      _______                                                                              >( ')           >( ')                                       (                  ( _|   |           |                                                                                                                                          ",
      O                     O                                                                                                                                                                                                                        ___                                                                                                                              |\/   )) .\                                                          >( ')                                                                          (                  (__|   |        ___|                                                                                             ___                                          ",
_____|-|                   |-|________________________                                                                                                                                                                                              \ \  \                                                                                   ___                                      |/\_______/                                                                                       >( ')                                             (                     |   |       | __|                                                                                            \ \  \                                        ",
/\__/| |                   | |\__/\__/\__/\__/\__/\__/|                                                                                                                    ___                                                                      / /  /                                                                                 / /  /                                                                                                                       >( ')                                     ___                     (                      \   \      |___|                                                                                            / /  /                                 ___    ",
___|_| |                   | |__|___|___|___|___|___|_|                            ___                                                                                    \ \  \                                                           ___      \ \  \                                                                                 \ \  \                                                                                    ___                                                                        /  / /                    (                        ___         /                                                                           ___               \ \  \                                \ \  \  ",
_|___| |                   | ||___|___|___|___|___|___|                          /  / /                                                                          ___      / /  /                                                         /  / /     / /  /        ___                                                     ___              / /  /                                                                                   \ \  \                                                                      \  \ \                    (______________________/ /  /_______/                                                                           \ \  \             / /  /                                / /  /  ",
___|_| |                   | |__|___|___|___|___|___|_|                          \  \ \                                                                ___      \ \  \    \ \  \                                                         \  \ \     \ \  \  __  /  / /                                                   \ \  \            \ \  \                                                                                   / /  /                                                               ___    /  / /   ___                        ( ___  /     \ \  \                                                                                   / /  /        __   \ \  \                        ___     \ \  \  ",
_|___| |                   | ||___|___|___|___|___|___|                          /  / /    ___                                                        /   |     / /  /    / /  /                                                         /  / /   __/_/  / /  | \  \ \                                                   / /  /    ___     / /  /                                                                           ___     \ \  \                                                              \  \ \  \  \ \  /   |                       ( __  /___   / /  /                                                                                   \ \  \       /  |  / /  /                       \ \  \   / /__/__",
___|_| |                   | |__|___|___|___|___|___|_|                          \  \ \   \ \  \                                                     |    |    _\_\  \    \ \  \                                                         \  \ \  /    |  \|    \/  / /                                                   \ \  \   \ \  \   \ \  \                                                                          \ \  \   / /  /                                                              /  / /  /  / / |    |    __                 ( _  / /  /  \ \  \                                                                                   / / _/__    |    \ \ \  \                       / /  /   \_/      
_|___| |                   | ||___|___|___|___|___|___|                          /  / /   / /  /                                                    /      \  |   \  /    / /  /                                                         /  /_/_/   _  \ /  |   |  \ \                                                   / /  /   / /  /   / /  /                                                                          / /  /   \ \  \                                                              \  \ \  \  \ \/      \  |   \               (___/\ \  \  / /  /                                                                                   \_/   _  \ /  |   |/ /  /                       \ \  \   /       ",
___|_| |                   | |__|___|___|___|___|___|_|                          \  \ \   \ \  \                                                   |   _/   \_/ _/ | \    \ \  \                                                         \  \/   __/    |    \   \ / /                                                   \ \  \   \ \  \   \ \  \                                                                          \ \  \   / /  /                                                              /  / /  /  / |   _/   \_/ _/ |                   / /  /  \ \  \                                                                                  /   __/    |    \   \ \  \                       / /  /  |        ",
